# Creatures

# Noto: Sekvante bonan Esperantan stilon (kaj ĉi-okaze la plej oftan
# stilon de la originala ludo), ne ĉiu vorto en nomo havas majusklon.

Baboon hawk=Pavian-vulturo     # scienca nomo = papio-volturius
Bracken=Brakeno
Bunker spider=Bunkro-araneo
Butler=Ĉefservisto
Circuit bees=Elektraj krabroj  # scienca nomo = crabro-coruscus
Coil-head=Risorto-kapo
Earth leviathan=Tera levjatano
Eyeless dog=Senokula hundo
Flowerman=Floroviro
Forest Giant=Arbara giganto
Forest keeper=Arbara giganto
Ghost girl=Fantomino
Hoarding bug=Kolekto-cimo
# Ŝajne «hygrodere» estas tajperaro, kaj ĝi estu «hydrogere».
# Mi sekvas tion kaj ankaŭ vortludas -- «hidro-» kaj «giro».
Hygrodere=Hidrogiro
Jeb=Ĝeb    # Ĉi tio estas la korporacia monstro, kiu aĉetas.
Jester=Spritulo
Landmine=Mino
Manticoil=Mantokorvo   # Ĝi estas ano de korvedoj, kaj havas mantecajn flugilojn
Mask Hornets=Maskaj Krabroj
Nutcracker=Nuksrompulo
Old Bird=Malnova Birdo
Roaming locusts=Vagantaj akridoj
Snare flea=Kapto-pulo
Spore lizard=Sporo-lacerto
Thumper=Frapulo
Tulip Snake=Tulip-Serpento
Turret=Pafilo    # «Tureto» estas la ŝirmejo ĉirkaŭ pafilo/kanono