# Interactive
#TODO: Review and Standardize

[ Not holding items ]=[Ne tenas aĵojn]
[Cannot pull valve]=[Ne povas entiri valvon]
[Hands full]=[Manoj plenaj]
[Nothing to store]=[Neniu por stoki]
[Pulling cord]=[Tiras Ŝnuron]
[Wait for ship to land]=[Atendu, ke la ŝipo alteriĝos]

# A-M
Access terminal : [E]=Aliri Terminalon: [E]

Beam up : [E]=Teleporti: [E]

Charge item : [E]=Ŝargi Aĵon: [E]
Climb : [E]=Grimpi: [E]
Close door : [E]=Fermi Pordon: [E]
Confirm: [B]   |   Rotate: [R]   |   Store: [X]=Konfermi: [B]  |   Pivoti: [R]  |   Formeti: [X]

Disable speaker: [E]=Malŝalti Parolilo: [E]

Enter : [E]=Eniri: [E]
Enter: [E]=Eniri: [E]
Enter a tag...=Enigu Etikedon...
Enter server tag...=Enigu Servilan Etikedon
Exit : [E]=Eliri: [E]
Exit: [E]=Eliri: [E]

Fire : [LMB]= Pafi: [LMB]
Flip switch: [E]=Baskuligi: [E]
Flush: [E]=Fluvi: [E]

Get log : [E]=Preni Komentarion: [E]
Grab : [E]=Preni: [E]
Grab: [E]=Preni: [E]

r:"^Hold(.*)"=Teni$1=
Hit pumpkin : [E]=Trafi Kukurbon: [E]
Hold: [Alt]=Depremi: [ALT]

Inspect: [Z]=Inspekti: [Z]

Land ship : [E]=Alteriĝi Ŝipon: [E]
Let go : [E]=Ellasi: [E]
Lift glass : [E]=Alti Vitron: [E]
r:"^Kick out (.*)"=Forpeli $1?

# N-Z
Open : [E]=Malfermi: [E]
Open door : [E]=Malfermi Pordon: [E]
Open hatch : [E]=Malfermi Lukon: [E]
Open: [E]=Malfermi: [E]
Open gift : [LMB]=Malferma Donacon: [LMB]

r:"^Pet Cat(.*)"=Glatumi Katon$1
Place on door : [LMB]=Meti sur Pordo: [LMB]
Play record: [E]=Ludi Diskon: [E]
Pop up ladder : [LMB]=Malfoldi Ŝtuparon: [LMB]
Power button : [Q]=Potenca Butono: [Q]
Pull pin : [LMB]=Tiri Pinglon: [LMB]
Pull pin: [LMB]=Tiri Pinglon: [lmb]
Pull switch : [E]=Tiri Ŝaltilon: [E]

Quit terminal : [TAB]=Lasi Terminalon: [TAB]

Reload : [E]=Reŝarĝi: [E]
Ring bell: [E]=Sonorigi Sonilon: [E]

Scan : [RMB]=Skani: [RMB]
r:"^Scan for threat:(.*)"=Skani por Minacon$1
Sell item : [E]=Vendi Aĵon: [E]
Send voice : [LMB]=Sendi Voĉon: [LMB]
Set candles: [E]=Meti Kandelojn: [LMB]
Shake can : [Q]=Agitigi Ladskatolo: [Q]
Sprint: [Shift]=Sprinti: [Shift]
Spray : [LMB]=Spraji: [LMB]
Squeeze : [E]=Stringi: [E]
Stab : [LMB]=Mortpiki: [LMB]
Start game : [E]=Ekludi: [E]
Start ship : [E]=Aktivigi Kosmoŝipo: [E]
Store item : [E]=Formeti Aĵon: [E]
Swing shovel : [LMB]=Svingi Fosilon: [LMB]
Swing sign : [LMB]=Svingi Signalon: [LMB]
Switch camera : [E]=Ŝanĝi Vidfotilon: [E]
Switch lights : [E]=Baskuligi Lumojn: [E]
r:"^Switch water(.*)"=Baskuligi Akvon$1

Take TZP : [LMB]=Ingesti TZP-n: [LMB]
Throw grenade: [LMB]=Ĵeti grenado: [LMB]
Toggle light : [LMB]=Baskuligi Lumon: [LMB]
Toggle laser : [LMB]=Baskuligi Lasero: [LMB]
Toggle music : [LMB]=Baskuligi Muzikon: [LMB]
Toss egg: [LMB]=Ĵetu ovon: [LMB]
Turn on booster : [LMB]=Aktivigi Amplifilon: [LMB]
Turn on/off : [E]=Ŝalti/Malŝalti: [E]
Turn safety on: [Q]=Ŝalti Sekurecon: [Q]
Turn safety off: [Q]=Malŝalti Sekurecon: [Q]
Turn page : [Q/E]=Ŝanĝi Folion: [Q/E]

Use airhorn : [LMB]=Uzi Aerkornon: [LMB]
Use cash register : [LMB]=Uzi Kasregistrilon: [LMB]
Use door : [E]=Uzi Pordon: [E]
Use grenade : [LMB]=Uzi Grenadon: [LMB]
Use hairdryer : [LMB]=Uzi Harsekigilon: [LMB]
Use DIY-Flashbang : [LMB]=Uzi FĜM-Ekbru-brileton: [LMB]
Use horn : [LMB]=Uzi Kornon: [LMB]
Use key : [LMB]=Uzi Ŝlosilon: [LMB]
Use key : [LMB]=Uzi Ŝlosilon: [LMB]
Use ladder : [E]=Uzi Ŝtuparon: [E]
Use Large axle : [G]=Uzi Grandan Akson: [G]
Use remote : [LMB]=Uzi Teleregilon: [LMB]

Walk : [W/A/S/D]=Marŝi: [W/A/S/D]
r:"^Wear mask(.*)"=Porti Maskon$1

sr:"^(.+) \((.+)\) : (.+)\n$"=$1 ($2):$3